"Months","Monthly payment","Monthly interest","Remaining balance"
"1","1798,65","1500,00","645715,92"
"2","1798,65","1492,50","643917,26"
"3","1798,65","1485,04","642118,61"
"4","1798,65","1477,61","640319,96"
"5","1798,65","1470,22","638521,31"
"6","1798,65","1462,87","636722,66"
"7","1798,65","1455,56","634924,01"
"8","1798,65","1448,28","633125,35"
"9","1798,65","1441,04","631326,70"
"10","1798,65","1433,83","629528,05"
"11","1798,65","1426,67","627729,40"
"12","1798,65","1419,53","625930,75"
"13","1798,65","1412,43","624132,10"
"14","1798,65","1405,37","622333,45"
"15","1798,65","1398,35","620534,79"
"16","1798,65","1391,35","618736,14"
"17","1798,65","1384,40","616937,49"
"18","1798,65","1377,47","615138,84"
"19","1798,65","1370,59","613340,19"
"20","1798,65","1363,73","611541,54"
"21","1798,65","1356,92","609742,88"
"22","1798,65","1350,13","607944,23"
"23","1798,65","1343,38","606145,58"
"24","1798,65","1336,66","604346,93"
"25","1798,65","1329,98","602548,28"
"26","1798,65","1323,33","600749,63"
"27","1798,65","1316,71","598950,97"
"28","1798,65","1310,13","597152,32"
"29","1798,65","1303,58","595353,67"
"30","1798,65","1297,06","593555,02"
"31","1798,65","1290,58","591756,37"
"32","1798,65","1284,12","589957,72"
"33","1798,65","1277,70","588159,07"
"34","1798,65","1271,31","586360,41"
"35","1798,65","1264,96","584561,76"
"36","1798,65","1258,63","582763,11"
"37","1798,65","1252,34","580964,46"
"38","1798,65","1246,08","579165,81"
"39","1798,65","1239,85","577367,16"
"40","1798,65","1233,65","575568,50"
"41","1798,65","1227,48","573769,85"
"42","1798,65","1221,34","571971,20"
"43","1798,65","1215,24","570172,55"
"44","1798,65","1209,16","568373,90"
"45","1798,65","1203,11","566575,25"
"46","1798,65","1197,10","564776,59"
"47","1798,65","1191,11","562977,94"
"48","1798,65","1185,16","561179,29"
"49","1798,65","1179,23","559380,64"
"50","1798,65","1173,34","557581,99"
"51","1798,65","1167,47","555783,34"
"52","1798,65","1161,63","553984,69"
"53","1798,65","1155,82","552186,03"
"54","1798,65","1150,04","550387,38"
"55","1798,65","1144,29","548588,73"
"56","1798,65","1138,57","546790,08"
"57","1798,65","1132,88","544991,43"
"58","1798,65","1127,22","543192,78"
"59","1798,65","1121,58","541394,12"
"60","1798,65","1115,97","539595,47"
"61","1798,65","1110,39","537796,82"
"62","1798,65","1104,84","535998,17"
"63","1798,65","1099,32","534199,52"
"64","1798,65","1093,82","532400,87"
"65","1798,65","1088,35","530602,21"
"66","1798,65","1082,91","528803,56"
"67","1798,65","1077,49","527004,91"
"68","1798,65","1072,11","525206,26"
"69","1798,65","1066,75","523407,61"
"70","1798,65","1061,41","521608,96"
"71","1798,65","1056,10","519810,31"
"72","1798,65","1050,82","518011,65"
"73","1798,65","1045,57","516213,00"
"74","1798,65","1040,34","514414,35"
"75","1798,65","1035,14","512615,70"
"76","1798,65","1029,96","510817,05"
"77","1798,65","1024,81","509018,40"
"78","1798,65","1019,69","507219,74"
"79","1798,65","1014,59","505421,09"
"80","1798,65","1009,52","503622,44"
"81","1798,65","1004,47","501823,79"
"82","1798,65","999,45","500025,14"
"83","1798,65","994,45","498226,49"
"84","1798,65","989,48","496427,83"
"85","1798,65","984,53","494629,18"
"86","1798,65","979,61","492830,53"
"87","1798,65","974,71","491031,88"
"88","1798,65","969,84","489233,23"
"89","1798,65","964,99","487434,58"
"90","1798,65","960,16","485635,93"
"91","1798,65","955,36","483837,27"
"92","1798,65","950,59","482038,62"
"93","1798,65","945,83","480239,97"
"94","1798,65","941,10","478441,32"
"95","1798,65","936,40","476642,67"
"96","1798,65","931,72","474844,02"
"97","1798,65","927,06","473045,36"
"98","1798,65","922,42","471246,71"
"99","1798,65","917,81","469448,06"
"100","1798,65","913,22","467649,41"
"101","1798,65","908,66","465850,76"
"102","1798,65","904,11","464052,11"
"103","1798,65","899,59","462253,45"
"104","1798,65","895,09","460454,80"
"105","1798,65","890,62","458656,15"
"106","1798,65","886,17","456857,50"
"107","1798,65","881,73","455058,85"
"108","1798,65","877,33","453260,20"
"109","1798,65","872,94","451461,55"
"110","1798,65","868,57","449662,89"
"111","1798,65","864,23","447864,24"
"112","1798,65","859,91","446065,59"
"113","1798,65","855,61","444266,94"
"114","1798,65","851,33","442468,29"
"115","1798,65","847,08","440669,64"
"116","1798,65","842,84","438870,98"
"117","1798,65","838,63","437072,33"
"118","1798,65","834,43","435273,68"
"119","1798,65","830,26","433475,03"
"120","1798,65","826,11","431676,38"
"121","1798,65","821,98","429877,73"
"122","1798,65","817,87","428079,07"
"123","1798,65","813,78","426280,42"
"124","1798,65","809,71","424481,77"
"125","1798,65","805,66","422683,12"
"126","1798,65","801,63","420884,47"
"127","1798,65","797,63","419085,82"
"128","1798,65","793,64","417287,17"
"129","1798,65","789,67","415488,51"
"130","1798,65","785,72","413689,86"
"131","1798,65","781,79","411891,21"
"132","1798,65","777,88","410092,56"
"133","1798,65","773,99","408293,91"
"134","1798,65","770,12","406495,26"
"135","1798,65","766,27","404696,60"
"136","1798,65","762,44","402897,95"
"137","1798,65","758,63","401099,30"
"138","1798,65","754,84","399300,65"
"139","1798,65","751,06","397502,00"
"140","1798,65","747,31","395703,35"
"141","1798,65","743,57","393904,70"
"142","1798,65","739,85","392106,04"
"143","1798,65","736,15","390307,39"
"144","1798,65","732,47","388508,74"
"145","1798,65","728,81","386710,09"
"146","1798,65","725,17","384911,44"
"147","1798,65","721,54","383112,79"
"148","1798,65","717,93","381314,13"
"149","1798,65","714,34","379515,48"
"150","1798,65","710,77","377716,83"
"151","1798,65","707,22","375918,18"
"152","1798,65","703,68","374119,53"
"153","1798,65","700,16","372320,88"
"154","1798,65","696,66","370522,22"
"155","1798,65","693,18","368723,57"
"156","1798,65","689,71","366924,92"
"157","1798,65","686,27","365126,27"
"158","1798,65","682,83","363327,62"
"159","1798,65","679,42","361528,97"
"160","1798,65","676,02","359730,32"
"161","1798,65","672,64","357931,66"
"162","1798,65","669,28","356133,01"
"163","1798,65","665,93","354334,36"
"164","1798,65","662,60","352535,71"
"165","1798,65","659,29","350737,06"
"166","1798,65","655,99","348938,41"
"167","1798,65","652,71","347139,75"
"168","1798,65","649,45","345341,10"
"169","1798,65","646,20","343542,45"
"170","1798,65","642,97","341743,80"
"171","1798,65","639,76","339945,15"
"172","1798,65","636,56","338146,50"
"173","1798,65","633,38","336347,84"
"174","1798,65","630,21","334549,19"
"175","1798,65","627,06","332750,54"
"176","1798,65","623,92","330951,89"
"177","1798,65","620,80","329153,24"
"178","1798,65","617,70","327354,59"
"179","1798,65","614,61","325555,94"
"180","1798,65","611,54","323757,28"
"181","1798,65","608,48","321958,63"
"182","1798,65","605,44","320159,98"
"183","1798,65","602,41","318361,33"
"184","1798,65","599,40","316562,68"
"185","1798,65","596,40","314764,03"
"186","1798,65","593,42","312965,37"
"187","1798,65","590,45","311166,72"
"188","1798,65","587,50","309368,07"
"189","1798,65","584,56","307569,42"
"190","1798,65","581,64","305770,77"
"191","1798,65","578,73","303972,12"
"192","1798,65","575,84","302173,46"
"193","1798,65","572,96","300374,81"
"194","1798,65","570,09","298576,16"
"195","1798,65","567,24","296777,51"
"196","1798,65","564,41","294978,86"
"197","1798,65","561,58","293180,21"
"198","1798,65","558,78","291381,56"
"199","1798,65","555,98","289582,90"
"200","1798,65","553,20","287784,25"
"201","1798,65","550,44","285985,60"
"202","1798,65","547,68","284186,95"
"203","1798,65","544,95","282388,30"
"204","1798,65","542,22","280589,65"
"205","1798,65","539,51","278790,99"
"206","1798,65","536,81","276992,34"
"207","1798,65","534,13","275193,69"
"208","1798,65","531,46","273395,04"
"209","1798,65","528,80","271596,39"
"210","1798,65","526,16","269797,74"
"211","1798,65","523,53","267999,08"
"212","1798,65","520,91","266200,43"
"213","1798,65","518,30","264401,78"
"214","1798,65","515,71","262603,13"
"215","1798,65","513,13","260804,48"
"216","1798,65","510,57","259005,83"
"217","1798,65","508,02","257207,18"
"218","1798,65","505,48","255408,52"
"219","1798,65","502,95","253609,87"
"220","1798,65","500,43","251811,22"
"221","1798,65","497,93","250012,57"
"222","1798,65","495,44","248213,92"
"223","1798,65","492,96","246415,27"
"224","1798,65","490,50","244616,61"
"225","1798,65","488,05","242817,96"
"226","1798,65","485,61","241019,31"
"227","1798,65","483,18","239220,66"
"228","1798,65","480,76","237422,01"
"229","1798,65","478,36","235623,36"
"230","1798,65","475,97","233824,70"
"231","1798,65","473,59","232026,05"
"232","1798,65","471,22","230227,40"
"233","1798,65","468,86","228428,75"
"234","1798,65","466,52","226630,10"
"235","1798,65","464,19","224831,45"
"236","1798,65","461,87","223032,80"
"237","1798,65","459,56","221234,14"
"238","1798,65","457,26","219435,49"
"239","1798,65","454,97","217636,84"
"240","1798,65","452,70","215838,19"
"241","1798,65","450,43","214039,54"
"242","1798,65","448,18","212240,89"
"243","1798,65","445,94","210442,23"
"244","1798,65","443,71","208643,58"
"245","1798,65","441,49","206844,93"
"246","1798,65","439,28","205046,28"
"247","1798,65","437,09","203247,63"
"248","1798,65","434,90","201448,98"
"249","1798,65","432,73","199650,32"
"250","1798,65","430,56","197851,67"
"251","1798,65","428,41","196053,02"
"252","1798,65","426,27","194254,37"
"253","1798,65","424,14","192455,72"
"254","1798,65","422,02","190657,07"
"255","1798,65","419,91","188858,42"
"256","1798,65","417,81","187059,76"
"257","1798,65","415,72","185261,11"
"258","1798,65","413,64","183462,46"
"259","1798,65","411,57","181663,81"
"260","1798,65","409,51","179865,16"
"261","1798,65","407,47","178066,51"
"262","1798,65","405,43","176267,85"
"263","1798,65","403,40","174469,20"
"264","1798,65","401,39","172670,55"
"265","1798,65","399,38","170871,90"
"266","1798,65","397,38","169073,25"
"267","1798,65","395,39","167274,60"
"268","1798,65","393,42","165475,94"
"269","1798,65","391,45","163677,29"
"270","1798,65","389,49","161878,64"
"271","1798,65","387,55","160079,99"
"272","1798,65","385,61","158281,34"
"273","1798,65","383,68","156482,69"
"274","1798,65","381,76","154684,04"
"275","1798,65","379,85","152885,38"
"276","1798,65","377,95","151086,73"
"277","1798,65","376,06","149288,08"
"278","1798,65","374,18","147489,43"
"279","1798,65","372,31","145690,78"
"280","1798,65","370,45","143892,13"
"281","1798,65","368,60","142093,47"
"282","1798,65","366,76","140294,82"
"283","1798,65","364,92","138496,17"
"284","1798,65","363,10","136697,52"
"285","1798,65","361,28","134898,87"
"286","1798,65","359,48","133100,22"
"287","1798,65","357,68","131301,57"
"288","1798,65","355,89","129502,91"
"289","1798,65","354,11","127704,26"
"290","1798,65","352,34","125905,61"
"291","1798,65","350,58","124106,96"
"292","1798,65","348,83","122308,31"
"293","1798,65","347,08","120509,66"
"294","1798,65","345,35","118711,00"
"295","1798,65","343,62","116912,35"
"296","1798,65","341,90","115113,70"
"297","1798,65","340,19","113315,05"
"298","1798,65","338,49","111516,40"
"299","1798,65","336,80","109717,75"
"300","1798,65","335,11","107919,09"
"301","1798,65","333,44","106120,44"
"302","1798,65","331,77","104321,79"
"303","1798,65","330,11","102523,14"
"304","1798,65","328,46","100724,49"
"305","1798,65","326,82","98925,84"
"306","1798,65","325,19","97127,19"
"307","1798,65","323,56","95328,53"
"308","1798,65","321,94","93529,88"
"309","1798,65","320,33","91731,23"
"310","1798,65","318,73","89932,58"
"311","1798,65","317,14","88133,93"
"312","1798,65","315,55","86335,28"
"313","1798,65","313,97","84536,62"
"314","1798,65","312,40","82737,97"
"315","1798,65","310,84","80939,32"
"316","1798,65","309,29","79140,67"
"317","1798,65","307,74","77342,02"
"318","1798,65","306,20","75543,37"
"319","1798,65","304,67","73744,71"
"320","1798,65","303,15","71946,06"
"321","1798,65","301,63","70147,41"
"322","1798,65","300,12","68348,76"
"323","1798,65","298,62","66550,11"
"324","1798,65","297,13","64751,46"
"325","1798,65","295,64","62952,81"
"326","1798,65","294,17","61154,15"
"327","1798,65","292,70","59355,50"
"328","1798,65","291,23","57556,85"
"329","1798,65","289,78","55758,20"
"330","1798,65","288,33","53959,55"
"331","1798,65","286,89","52160,90"
"332","1798,65","285,45","50362,24"
"333","1798,65","284,02","48563,59"
"334","1798,65","282,60","46764,94"
"335","1798,65","281,19","44966,29"
"336","1798,65","279,78","43167,64"
"337","1798,65","278,39","41368,99"
"338","1798,65","276,99","39570,33"
"339","1798,65","275,61","37771,68"
"340","1798,65","274,23","35973,03"
"341","1798,65","272,86","34174,38"
"342","1798,65","271,49","32375,73"
"343","1798,65","270,14","30577,08"
"344","1798,65","268,79","28778,43"
"345","1798,65","267,44","26979,77"
"346","1798,65","266,11","25181,12"
"347","1798,65","264,78","23382,47"
"348","1798,65","263,45","21583,82"
"349","1798,65","262,13","19785,17"
"350","1798,65","260,82","17986,52"
"351","1798,65","259,52","16187,86"
"352","1798,65","258,22","14389,21"
"353","1798,65","256,93","12590,56"
"354","1798,65","255,65","10791,91"
"355","1798,65","254,37","8993,26"
"356","1798,65","253,10","7194,61"
"357","1798,65","251,83","5395,95"
"358","1798,65","250,57","3597,30"
"359","1798,65","249,32","1798,65"
"360","1798,65","248,07","0,00"
